[{
    "title": "Starting demo level",
    "map_data": [
        "_########",
        "##      #",
        "#  #.   #",
        "#   $   #",
        "# .$@$. #",
        "####$   #",
        "___#.   #",
        "___#    #",
        "___######"
    ]
}]